Chi	Eng
李	Lee
王	Wong
張	Cheung
劉	Liu
陳	Chan
楊	Yeung
黃	Wong
趙	Chiu
周	Chow
吳	Ng
徐	Tsui
孫	Sun
朱	Chu
馬	Ma
胡	Wu
郭	Kwok
林	Lam
何	Ho
高	Ko
梁	Leung
鄭	Cheng
羅	Law
宋	Song
謝	Tse
唐	Tong
韓	Hon
曹	Cho
許	Hui
鄧	Tang
蕭	Siu
馮	Fung
曾	Tsang
程	Ching
蔡	Choy
彭	Pan
潘	Poon
袁	Yuen
於	Yue
董	Tong
餘	Yu
蘇	So
葉	Yip
呂	Lui
魏	Wei
蔣	Cheung
田	Tin
杜	To
丁	Ting
沈	Sham
姜	Keung
范	Fan
江	Kong
傅	Fu
鍾	Chung
盧	Lo
汪	W
戴	Tai
任	Yim
陸	Luk
廖	Liu
姚	Yiu
方	Fung
金	Kam
邱	Yau
夏	Ha
譚	Tam
韋	Wai
賈	Ka
鄒	Chwo
石	Shek
熊	Hung
薛	Sit
侯	Hou
雷	Lui
白	Pak
龍	Lung
孔	Hung
邵	Sui
史	Se
毛	Mo
萬	Man
顧	kwu
賴	Lai
武	Mo
康	Hou
賀	Ho
嚴	Yim
尹	Wan
施	Sze
洪	Hung
香	Heung
莫	Mok
屈	Wut